{
  "q": "a",
  "w": "z",
  "e": "e",
  "r": "r",
  "t": "t",
  "y": "y",
  "u": "u",
  "i": "i",
  "o": "o",
  "p": "p",
  "a": "q",
  "s": "s",
  "d": "d",
  "f": "f",
  "g": "g",
  "h": "h",
  "j": "j",
  "k": "k",
  "l": "l",
  ";": "m",
  "z": "w",
  "x": "x",
  "c": "c",
  "v": "v",
  "b": "b",
  "n": "n",
  "m": ","
}
