{
  "q": "q",
  "w": "w",
  "e": "d",
  "r": "f",
  "t": "k",
  "y": "j",
  "u": "u",
  "i": "r",
  "o": "l",
  "p": ";",
  "a": "a",
  "s": "s",
  "d": "e",
  "f": "t",
  "g": "g",
  "h": "y",
  "j": "n",
  "k": "i",
  "l": "o",
  ";": "h",
  "z": "z",
  "x": "x",
  "c": "c",
  "v": "v",
  "b": "b",
  "n": "p",
  "m": "m"
}
